1111111111111111111111111111111111
10000000000000C00000C0000000000001
1010010100100001010010000000110011
10100100101101000100100000001E1111
1P0000000C0C0000000000000000000C11
10000000000000C00000C0000000000001
1010010100100001010010000001010011
10000000000000C000C0C0000000000001
1010010100100001010010000000101001
10000000000001C10000C0000000000001
1010010100100011010010000000101001
1111111111111111111111111111111111